R 800 600

NO ./textures/texture_1.xpm
SO ./textures/texture_2.xpm
WE ./textures/texture_3.xpm
EA ./textures/texture_4.xpm

S ./textures/sprit.xpm
F 220,100,0
C 12,200,100

1111111111111111111111
1000000000002000000001
1000000000000000002001
1000000000000000000001
1002222000002222000001
1000222200000222200001
10022220000002222000011111
1000000000S000000000000001
10000000000000000000011111
1000200020000000000001
1000000000000000200001
1000000000000000000001
1000111111111100000001
1000200000000000000001
1111111111111111111111